N:random
T:200
S:15,17
D:3,0,3,0,3,0,0,0,0,0,0,0,0,0,0
D:0,0,0,0,3,0,3,0,3,0,0,0,0,0,0
D:0,0,0,3,0,0,3,2,0,3,0,0,0,0,0
D:0,0,0,0,0,0,0,2,0,3,0,3,0,0,0
D:0,2,0,0,0,0,0,2,3,0,0,3,0,0,0
D:3,2,0,0,2,0,0,2,0,0,0,0,0,3,0
D:0,2,0,3,2,3,0,2,0,0,3,0,0,0,0
D:3,2,0,0,2,0,0,0,0,3,0,0,0,0,0
D:0,0,2,0,0,3,0,3,0,3,0,0,2,0,0
D:0,0,0,0,0,3,0,0,0,0,2,0,0,2,3
D:0,0,0,0,3,0,0,2,0,3,2,3,0,2,0
D:0,3,0,0,0,0,0,2,0,0,2,0,0,2,3
D:0,0,0,3,0,0,3,2,0,0,0,0,0,2,0
D:0,0,0,3,0,3,0,2,0,0,0,0,0,0,0
D:0,0,0,0,0,3,0,2,3,0,0,3,0,0,0
D:0,0,0,0,0,0,3,0,3,0,3,0,0,0,0
D:0,0,0,0,0,0,0,0,0,0,3,0,3,0,3
H:9,13
C:5,3
